1111111111111
1010101000001
100C0000000D1
111001P111111
1100010E00001
1111111111111
