1111111111111
10010E00C0001
1000011111001
110011P000001
1111111111111
