1111111111111
1CCCCCCCCCCC1
1CCCCCCCCCCD1
1CCCCCPCCCCC1
1CCCCCCECCCC1
1111111111111
