1111111111111
1C101010C0001
1000000000001
1110011100111
110001PE000C1
1111111111111
