1111111111111
1C101E10C0001
1000000000001
1110011111111
110001P0000C1
1111111111111
