1111111111111
1C010E00C0001
1000011111001
110011P0000C1
1111111111111
