1111111111111
1C000E00C0001
1111111111101
110011P1000C1
1111111111111
