1111111111111
1C000000000C1
1000D000000D1
100C00P000001
1C1C000E00001
1111111111111
