1111111111111
1C101010C0001
10000000000D1
1110011100111
110001PE000C1
1111111111111
