11111111111111111111111
100C00C0000010C00000001
1111111D00C000C01111101
1P00000D0111000000000E1
100C0011110000011100001
1000000C0000000C0000001
11111111111111111111111
