111111111111111111111111111111111111111111
1P0000000000000000000000000000000000000001
100000000000000000000000000000000000000001
1000000DCD0DCD0000CCCC00000000011011000001
1000000DCD0DCD0000C00CC0000000010010010001
1000000DCDDDCD000000CC00000000010000010001
1000000DCCCCCD00000CC000000000001000100001
1000000DDDDCCD0000CCC000000000000101000001
1000000000DCCD000CCCCCC0000000000010000001
1000000000DDDD0000000000000000000000000001
1000000000000000000000000000000000000000E1
111111111111111111111111111111111111111111
