1111111111111
10E10000000C1
1000011111001
110011P0000E1
1111111111111
