1111111111111
10010000000C1
100P011111001
11P011E000001
1111111111111
