1111111111111111
10000P00000E0001
100000CCCCCC0001
11111111